WE   ./img/texture/dark_tree_5.xpm
EA    ./img/texture/dark_tree_3.xpm 
NO    ./img/texture/dark_tree_4.xpm
SO    ./img/texture/dark_tree_1.xpm
C 1,0,36
F 0,50,5
S2 ./img/sprite/red_eyes.xpm
S ./img/sprite/ghost.xpm
R 1200 700

11111111111111111111111111111111111
11000000110000311000101010000000000111111
10000001000000010000000000200000111111
1000000000000001000000000000000111111111
10000001010000010000203000N0000022000001
1000000101000001000000000000000000111111
10000200000000000000000020030000001
10000000000000000000000000000000001
101111110111111111110000000000000001
10010101110001000001000000000000001
10000000000000200000000000000000001
11111111111111111111111001101111111
10000100000001000000000000100000021
10000000000000000000000000100000011
11111111111110111111111011111000011
000         10001     13100000111111
            11101     10100111111111
              101     10100100111111
               1      10030003111111
                      10103030111111
                      11111111111111
