          NO ./img/texture/dark_tree_4.xpm
                       SO ./img/texture/rick.xpm
C 123,0,36
S2 ./img/sprite/red_eyes.xpm













S ./img/sprite/heart.xpm
R 1200 750










                   WE ./img/texture/dark_tree_5.xpm





F 0,47,5





                   EA                       ./img/texture/dark_tree_3.xpm
1111111111111111111111111111111111111111111
1000000000000000000001000000000000000000001
1000000000000000000001000000000000000000001
1000000000000000000001000000000000000000001
1000000000000000000001000000000000000000001
1000000000000000000001000000000000000000001
1000000000000000000001000000000000000000001
1000000000000000000001000000000000000000001
1000000000000000000001000000000000000000001
1000000000000000000001000000000000000000001
1000000000000000000001000000000000000000001
1000000000000000000001000000000000000000001
1000000000000000020001000000000000000000001
1000000000000020000001000000000000000000001
1000000000000000020001000000000000000000001
1000000000000000020001000000000000000000001
1000000000000000020001000003000000000000001
1000000000000000000001000000000000000000001
1000000E00000000030000300300000330000000001
1000000000000020000001000000000000000000001
1000000000000000000001000333000000000000001
1000000000000000000001000000000000000000001
1000000000000000000001000000000000000000001
1000000000000000000001000000000000000000001
1000000000000000000001000000000000000000001
1000000000000000000001000000000000000000001
1000000000000000000001000000000000000000001
1000000000000000000001000000000000000000001
1000000000000000000001000000000000000000001
1000000000000000000001000000000000000000001
1000000000000000000001000000000000000000001
1000000000000000000001000000000000000000001
1000000000000000000001000000000000000000001
1000000000000000000001000000000000000000001
1000000000000000000001000000000000000000001
1111111111111111111111111111111111111111111
