
R  1720  900


SO ./img/texture/dark_tree_1.xpm
WE ./img/texture/dark_tree_5.xpm
EA ./img/texture/dark_tree_3.xpm
NO ./img/texture/dark_tree_4.xpm


                                               S   img/sprite/red_eyes.xpm
                                               S2  img/sprite/ghost.xpm





                                           C      1,2,3

   F      100,5,6






1111111111
1200000031
1110011111
1111011
1E0001
111111

